RECOMMEND_LOCATION	NONE, LOCATION
RECOMMEND_EAT	EAT, NONE
RECOMMEND_TEENAGE	TEENAGE, NONE
RECOMMEND_PET	PET, NONE
RECOMMEND_ALCOHOL	ALCOHOL, NONE
RECOMMEND_SMOKE	SMOKE, NONE
RECOMMEND_NATURE	NATURE, NONE
RECOMMEND_HOME-LIKE	HOME-LIKE, NONE
RECOMMEND_LUXURY	LUXURY, NONE
RECOMMEND_TRADITIONAL	TRADITIONAL, NONE
RECOMMEND_EXOTIC	EXOTIC, NONE
RECOMMEND_SCENT-GOOD	SCENT-GOOD, NONE
RECOMMEND_MOOD-GOOD	MOOD-GOOD, NONE
RECOMMEND_VIEW-GOOD	VIEW-GOOD, NONE
RECOMMEND_ROOM-NUM	ROOM-NUM, NONE
RECOMMEND_UNSHARED	UNSHARED, NONE
RECOMMEND_NEW	NEW, NONE
RECOMMEND_SPLIT-LEVEL	SPLIT-LEVEL, NONE
RECOMMEND_INTERIOR-GOOD	INTERIOR-GOOD, NONE
RECOMMEND_GOOD-TO-GO	GOOD-TO-GO, NONE
RECOMMEND_FIRE-PLACE	FIRE-PLACE, NONE
RECOMMEND_WATER-POWER	WATER-POWER, NONE
RECOMMEND_SOUND-PROOF	SOUND-PROOF, NONE
RECOMMEND_HOT-WATER	HOT-WATER, NONE
RECOMMEND_PROVIDED	PROVIDED, NONE
RECOMMEND_PILLOW-GOOD	PILLOW-GOOD, NONE
RECOMMEND_BED-NUMBER	BED-NUMBER, NONE
RECOMMEND_BED-OPTION	BED-OPTION, NONE
RECOMMEND_BED-TWIN	BED-TWIN, NONE
RECOMMEND_BED-SIZE	BED-SIZE, NONE
RECOMMEND_BED-GOOD	BED-GOOD, NONE
RECOMMEND_SAFETY	SAFETY, NONE
RECOMMEND_BAN	BAN, NONE
RECOMMEND_REVIEW	REVIEW, NONE
RECOMMEND_PRICE	PRICE, NONE
RECOMMEND_SIZE	SIZE, NONE
RECOMMEND_SERVICE	SERVICE, NONE
RECOMMEND_CLEANNESS	CLEANNESS, NONE
RECOMMEND_TRANSPORTATION	TRANSPORTATION, NONE
RECOMMEND_SURROUND	SURROUND, NONE
RECOMMEND_ALL-FEATURE	NONE, ALL-FEATURE
VALET	VALET, NONE
ROOM-UPGRADE	ROOM-UPGRADE, NONE
ROOM-SERVICE	ROOM-SERVICE, NONE
MEAL	MEAL, NONE
DAYUSE	DAYUSE, NONE
PICKUP	PICKUP, NONE
SELF-CHECKIN	SELF-CHECKIN, NONE
LATE-CHECKIN	LATE-CHECKIN, NONE
EARLY-CHECKIN	EARLY-CHECKIN, NONE
WINE	WINE, NONE
PILL	PILL, NONE
DRINK	DRINK, NONE
GARDEN	GARDEN, NONE
TERRACE	TERRACE, NONE
AIRCLEANER	AIRCLEANER, NONE
WASHER	WASHER, NONE
TV	TV, NONE
SMART-TV	SMART-TV, NONE
AIRCONDITIONER	AIRCONDITIONER, NONE
BATH	BATH, NONE
BED	BED, NONE
FACILITY-GEN	FACILITY-GEN, NONE
PARKING	PARKING, NONE
ELEVATOR	ELEVATOR, NONE
SHOWER	SHOWER, NONE
PLAYGROUND	PLAYGROUND, NONE
SPORTS	SPORTS, NONE
GYM	GYM, NONE
KARAOKE	KARAOKE, NONE
BAR	BAR, NONE
HOTSPRING	HOTSPRING, NONE
ONDOLBANG	ONDOLBANG, NONE
POOL	POOL, NONE
BARBEQUE	BARBEQUE, NONE
COMPUTER	COMPUTER, NONE
BUGSPRAY	BUGSPRAY, NONE
GAME	GAME, NONE
PORT	PORT, NONE
COOKER	COOKER, NONE
COOKWARE	COOKWARE, NONE
CHARGER	CHARGER, NONE
DRYER	DRYER, NONE
BEACHWARE	BEACHWARE, NONE
SPARE-KEY	SPARE-KEY, NONE
BEAUTY	BEAUTY, NONE
SANITIZER	SANITIZER, NONE
GOWN	GOWN, NONE
TOILETRY	TOILETRY, NONE
TOWEL	TOWEL, NONE
SLEEPING-OPTION	SLEEPING-OPTION, NONE
GARDEN-VERB	GARDEN, NONE
TERRACE-VERB	TERRACE, NONE
PARKING-VERB	PARKING, NONE
SHOWER-VERB	SHOWER, NONE
PLAYGROUND-VERB	PLAYGROUND, NONE
SPORTS-VERB	SPORTS, NONE
GYM-VERB	GYM, NONE
KARAOKE-VERB	KARAOKE, NONE
BAR-VERB	BAR, NONE
HOTSPRING-VERB	HOTSPRING, NONE
ONDOLBANG-VERB	ONDOLBANG, NONE
BARBEQUE-VERB	BARBEQUE, NONE
TV-VERB	TV, NONE
SMART-TV-VERB	SMART-TV, NONE
AIRCLEANER-VERB	AIRCLEANER, NONE
WASHER-VERB	WASHER, NONE
AIRCONDITIONER-VERB	AIRCONDITIONER, NONE
COMPUTER-VERB	COMPUTER, NONE
GAME-VERB	GAME, NONE
DRINK-VERB	DRINK, NONE
WIFI-VERB	WIFI, NONE
VALET-VERB	VALET, NONE
ROOM-UPGRADE-VERB	ROOM-UPGRADE, NONE
MEAL-VERB	MEAL, NONE
PICKUP-VERB	PICKUP, NONE
RIVER	RIVER, NONE
SEA	SEA, NONE
MOUNTAIN	MOUNTAIN, NONE
FAMILY	FAMILY, NONE
FRIEND	FRIEND, NONE
LOVER	LOVER, NONE
TRIPLE	TRIPLE, NONE
GROUP	GROUP, NONE
COUPLE	COUPLE, NONE
SOLO	SOLO, NONE
GIRLS	GIRLS, NONE
BOYS	BOYS, NONE
WINTER-SEASON	WINTER-SEASON, NONE
SUMMER-SEASON	SUMMER-SEASON, NONE
COVID-SEASON	COVID-SEASON, NONE
VACATION	VACATION, NONE
HEALING	HEALING, NONE
MT	MT, NONE
HONEY-MOON	HONEY-MOON, NONE
NONSMOKING	NONSMOKING, NONE
NOKIDS	NOKIDS, NONE
WATER-LEISURE	WATER-LEISURE, NONE
AMUSEMENT	AMUSEMENT, NONE
MART	MART, NONE
CAFE	CAFE, NONE
RESTAURANT	RESTAURANT, NONE
EAT	EAT, NONE
TEENAGE	TEENAGE, NONE
PET	PET, NONE
ALCOHOL	ALCOHOL, NONE
SMOKE	SMOKE, NONE
HOME-LIKE	HOME-LIKE, NONE
LUXURY	LUXURY, NONE
TRADITIONAL	TRADITIONAL, NONE
EXOTIC	EXOTIC, NONE
SCENT-GOOD	SCENT-GOOD, NONE
MOOD-GOOD	MOOD-GOOD, NONE
VIEW	VIEW, NONE
REVIEW	REVIEW, NONE
SERVICE	SERVICE, NONE
TRANSPORTATION	TRANSPORTATION, NONE
ROOM-NUM	ROOM-NUM, NONE
UNSHARED	UNSHARED, NONE
NEW	NEW, NONE
SPLIT-LEVEL	SPLIT-LEVEL, NONE
INTERIOR-GOOD	INTERIOR-GOOD, NONE
FIRE-PLACE	FIRE-PLACE, NONE
WATER-POWER	WATER-POWER, NONE
SOUND-PROOF	SOUND-PROOF, NONE
HOT-WATER	HOT-WATER, NONE
PILLOW-GOOD	PILLOW-GOOD, NONE
BED-NUMBER	BED-NUMBER, NONE
BED-OPTION	BED-OPTION, NONE
BED-TWIN	BED-TWIN, NONE
BED-SIZE	BED-SIZE, NONE
BED-GOOD	BED-GOOD, NONE
SAFETY	SAFETY, NONE
PRICE	PRICE, NONE
SIZE	SIZE, NONE
CLEANNESS	CLEANNESS, NONE
HOTEL	CATE, HOTEL
HYATT-HOTEL	SUB-CATEGORY, HYATT-HOTEL
SHILLA-HOTEL	SUB-CATEGORY, SHILLA-HOTEL
LOTTE-HOTEL	SUB-CATEGORY, LOTTE-HOTEL
MOTEL	CATE, MOTEL
PENSION	CATE, PENSION
GUEST-HOUSE	CATE, GUEST-HOUSE
HANOK	CATE, HANOK
CAMPING	CATE, CAMPING
HOSTEL	CATE, HOSTEL
ACCOMMODATION-GEN	CATE, ALL
RESORT	CATE, RESORT
MANGWON	CITY, MANGWON
SUNGSU	CITY, SUNGSU
SINCHON	CITY, SINCHON
ITAEWON	CITY, ITAEWON
SONGPA	CITY, SONGPA
JONGNO	CITY, JONGNO
GEONDAE	CITY, GEONDAE
HANGANG	CITY, HANGANG
HONGDAE	CITY, HONGDAE
GAROSUGIL	CITY, GAROSUGIL
GANGNAM	CITY, GANGNAM
EXPRESS-BUS-TERMINAL	CITY, EXPRESS-BUS-TERMINAL
JUNGGU	CITY, JUNGGU
DAEGU	CITY, DAEGU
WULSAN	CITY, WULSAN
DAEJEON	CITY, DAEJEON
BUSAN	CITY, BUSAN
JEONJU	CITY, JEONJU
GUNSAN	CITY, GUNSAN
IKSAN	CITY, IKSAN
JEONGEUP	CITY, JEONGEUP
NAMWON	CITY, NAMWON
GIMJE	CITY, GIMJE
WANJU	CITY, WANJU
JINAN	CITY, JINAN
MUJU	CITY, MUJU
JANGSU	CITY, JANGSU
IMSIL	CITY, IMSIL
SUNCHANG	CITY, SUNCHANG
GOCHANG	CITY, GOCHANG
BUAN	CITY, BUAN
CHEONAN	CITY, CHEONAN
GONGJU	CITY, GONGJU
BORYEONG	CITY, BORYEONG
ASAN	CITY, ASAN
SEOSAN	CITY, SEOSAN
NONSAN	CITY, NONSAN
GYERYONG	CITY, GYERYONG
DANGJIN	CITY, DANGJIN
GEUMSAN	CITY, GEUMSAN
BUYEO	CITY, BUYEO
SEOCHEON	CITY, SEOCHEON
CHEONGYANG	CITY, CHEONGYANG
HONGSEONG	CITY, HONGSEONG
YESAN	CITY, YESAN
TAEAN	CITY, TAEAN
CHEONGJU	CITY, CHEONGJU
CHUNGJU	CITY, CHUNGJU
JECHEON	CITY, JECHEON
BOEUN	CITY, BOEUN
OKCHEON	CITY, OKCHEON
YEONGDONG	CITY, YEONGDONG
JINCHEON	CITY, JINCHEON
GOISAN	CITY, GOISAN
EUMSEONG	CITY, EUMSEONG
DANYANG	CITY, DANYANG
JEUNGPYEONG	CITY, JEUNGPYEONG
JEJU	CITY, JEJU
SEGUIPO	CITY, SEGUIPO
GOSEONG	CITY, GOSEONG
CHANGWON	CITY, CHANGWON
JINJU	CITY, JINJU
TONGYEONG	CITY, TONGYEONG
SACHEON	CITY, SACHEON
UIRYEONG	CITY, UIRYEONG
HAMAN	CITY, HAMAN
CHANGNYEONG	CITY, CHANGNYEONG
GIMHAE	CITY, GIMHAE
MILYANG	CITY, MILYANG
GEOJE	CITY, GEOJE
YANGSAN	CITY, YANGSAN
NAMHAE	CITY, NAMHAE
HADONG	CITY, HADONG
SANCHEONG	CITY, SANCHEONG
HAMYANG	CITY, HAMYANG
GEOCHANG	CITY, GEOCHANG
HAPCHEON	CITY, HAPCHEON
POHANG	CITY, POHANG
GYEONGJU	CITY, GYEONGJU
GIMCHEON	CITY, GIMCHEON
ANDONG	CITY, ANDONG
MUNGYEONG	CITY, MUNGYEONG
GYEONGSAN	CITY, GYEONGSAN
GUNWI	CITY, GUNWI
UISEONG	CITY, UISEONG
GUMI	CITY, GUMI
YEONGJU	CITY, YEONGJU
YEONGCHEON	CITY, YEONGCHEON
SANGJU	CITY, SANGJU
CHEONGSONG	CITY, CHEONGSONG
YEONGYANG	CITY, YEONGYANG
YEONGDEOK	CITY, YEONGDEOK
CHEONGDO	CITY, CHEONGDO
GORYEONG	CITY, GORYEONG
SEONGJU	CITY, SEONGJU
CHILGOK	CITY, CHILGOK
YECHEON	CITY, YECHEON
BONGHWA	CITY, BONGHWA
WULJIN	CITY, WULJIN
WULLEUNG	CITY, WULLEUNG
MOKPO	CITY, MOKPO
YEOSU	CITY, YEOSU
SUNCHEON	CITY, SUNCHEON
NAJU	CITY, NAJU
GOHEUNG	CITY, GOHEUNG
BOSEONG	CITY, BOSEONG
HWASUN	CITY, HWASUN
JANGHEUNG	CITY, JANGHEUNG
GWANGYANG	CITY, GWANGYANG
DAMYANG	CITY, DAMYANG
GOKSEONG	CITY, GOKSEONG
GURYE	CITY, GURYE
GANGJIN	CITY, GANGJIN
HAENAM	CITY, HAENAM
YEONGAM	CITY, YEONGAM
MUAN	CITY, MUAN
HAMPYEONG	CITY, HAMPYEONG
YEONGGWANG	CITY, YEONGGWANG
JANGSEONG	CITY, JANGSEONG
WANDO	CITY, WANDO
JINDO	CITY, JINDO
SINAN	CITY, SINAN
GWANGJU	CITY, GWANGJU
CHUNCHEON	CITY, CHUNCHEON
WONJU	CITY, WONJU
GANGLEUNG	CITY, GANGLEUNG
DONGHAE	CITY, DONGHAE
TAEBAEK	CITY, TAEBAEK
SOKCHO	CITY, SOKCHO
SAMCHEOK	CITY, SAMCHEOK
HONGCHEON	CITY, HONGCHEON
HOINGSEONG	CITY, HOINGSEONG
YEONGWOL	CITY, YEONGWOL
PYEONGCHANG	CITY, PYEONGCHANG
JEONGSEON	CITY, JEONGSEON
CHEOLWON	CITY, CHEOLWON
HWACHEON	CITY, HWACHEON
YANGGU	CITY, YANGGU
INJE	CITY, INJE
YANGYANG	CITY, YANGYANG
SUWON	CITY, SUWON
SEONGNAM	CITY, SEONGNAM
GOYANG	CITY, GOYANG
YONGIN	CITY, YONGIN
BUCHEON	CITY, BUCHEON
ANSAN	CITY, ANSAN
ANYANG	CITY, ANYANG
HWASEONG	CITY, HWASEONG
PYEONGTAEK	CITY, PYEONGTAEK
UIJEONGBU	CITY, UIJEONGBU
SIHEUNG	CITY, SIHEUNG
PAJU	CITY, PAJU
GWANGMYEONG	CITY, GWANGMYEONG
GIMPO	CITY, GIMPO
GUNPO	CITY, GUNPO
GYEONGGI-GWANGJU	CITY, GYEONGGI
ICHEON	CITY, ICHEON
YANGJU	CITY, YANGJU
OSAN	CITY, OSAN
GURI	CITY, GURI
ANSEONG	CITY, ANSEONG
POCHEON	CITY, POCHEON
UIWANG	CITY, UIWANG
HANAM	CITY, HANAM
YEOJU	CITY, YEOJU
YANGPYEONG	CITY, YANGPYEONG
DONGDUCHEON	CITY, DONGDUCHEON
GWACHEON	CITY, GWACHEON
GAPYEONG	CITY, GAPYEONG
YEONCHEON	CITY, YEONCHEON
NAMYANGJU	CITY, NAMYANGJU
INCHEON	CITY, INCHEON
SEOUL	CITY-ONTO, SEOUL
YEONNAMDONG	CITY, YEONNAMDONG
SEONGDONG	CITY, SEONGDONG
GWANGJIN	CITY, GWANGJIN
DONGDAEMUN	CITY, DONGDAEMUN
JUNGRANG	CITY, JUNGRANG
SEONGBUK	CITY, SEONGBUK
GANGBUK	CITY, GANGBUK
DOBONG	CITY, DOBONG
NOWON	CITY, NOWON
SEODAEMUN	CITY, SEODAEMUN
MAPO	CITY, MAPO
GANGSEO	CITY, GANGSEO
GURO	CITY, GURO
GEUMCHEON	CITY, GEUMCHEON
GANGDONG	CITY, GANGDONG
GWANAK	CITY, GWANAK
DONGJAK	CITY, DONGJAK
TAESAN	CITY, TAESAN
NON-SMOKING	NONSMOKING, NONE
SLEEPING	SLEEPING-OPTION, NONE